{
	"width": 15,
	"height": 11,
	"tiles":[
		[7,7,7,7,0,1,0,0,0,0,0,0,0,0,0],
		[7,7,2,8,0,1,0,0,0,0,0,0,0,0,0],
		[7,1,7,8,0,3,2,2,2,2,2,2,2,6,0],
		[7,7,3,0,0,0,0,0,0,0,8,0,0,1,0],
		[0,8,7,0,0,0,0,0,0,0,0,0,0,1,7],
		[0,0,7,0,0,0,0,7,7,0,0,0,8,1,8],
		[0,0,0,0,0,0,0,8,7,0,0,0,0,1,7],
		[0,0,0,0,0,0,0,0,0,8,0,4,2,5,7],
		[0,0,0,0,0,0,0,4,2,2,2,5,7,7,7],
		[0,0,0,0,0,0,0,1,0,0,0,0,0,0,0],
		[0,0,0,0,0,0,8,1,8,0,0,0,0,0,0]
	],
	"enemyWayPoints": [
		[5,0], [5,2], [13,2], [13,7], [11,7], [11,8], [7,8], [7,10]
	]
}