{
  "width":15,
  "height":11,
  "tiles":[
    [0,0,0,0,0,0,0,0,0,0,0,0,0,0,0],
    [0,0,8,0,0,0,0,0,0,0,0,7,7,0,0],
    [0,0,8,4,2,2,2,2,6,0,8,0,0,0,0],
    [0,0,0,1,0,0,0,0,1,0,4,2,2,2,2],
    [0,0,0,1,0,7,7,0,1,0,1,0,0,0,0],
    [2,2,2,9,0,7,7,0,10,2,9,0,0,0,0],
    [0,0,0,1,0,7,7,0,1,0,1,0,0,0,0],
    [0,0,0,1,0,0,0,0,1,0,3,2,2,2,2],
    [0,0,0,3,2,2,2,2,5,0,0,0,0,0,0],
    [0,8,0,8,0,0,0,8,0,0,8,7,7,0,0],
    [0,0,0,0,0,0,0,0,0,0,0,0,0,0,0]
  ],
  "enemyWayPoints": [
    [0,5], [3,5], [3,2], [8,2], [8,5], [10,5], [10,7], [14,7]
  ]
}