{
  "width":15,
  "height":11,
  "tiles":[
      [7,1,7,0,0,0,0,0,0,0,0,0,0,0,0],
      [7,1,7,0,0,0,8,0,0,0,0,0,0,0,0],
      [0,1,0,0,0,0,0,0,0,8,0,0,0,0,0],
      [0,3,2,2,2,2,2,6,0,0,0,0,0,0,0],
      [0,0,0,0,0,0,0,1,0,0,7,7,7,0,0],
      [0,0,0,0,8,4,2,5,0,0,7,8,7,0,0],
      [0,0,0,0,0,1,0,8,0,0,7,7,7,0,0],
      [0,0,0,0,7,3,2,2,2,2,6,0,0,0,0],
      [0,0,0,8,0,0,7,0,0,0,1,0,0,0,0],
      [0,0,0,0,0,0,0,0,0,0,1,0,0,0,0],
      [0,0,0,0,0,0,0,0,0,8,1,8,0,0,0]
  ],
  "enemyWayPoints": [
    [1,0], [1,3], [7,3], [7,5], [5,5], [5,7], [10,7], [10,10]
  ]
}